############################################################
#                                                          #
#                                  S                       #
#                                                          #
#                                                          #
#                                                          #
#                                                          #
#                                                          #
#                                                          #
#                                                          #
#                                                          #
#                                                          #
# F                                                        #
#                                                          #
############################################################
