############################################################################
##################                     #####################################
################## ################### #####################################
################## ################### #####################################
#######F########## ################### #####################################
####### ########## ################### #####################################
####### ########## ###############                                    ######
####### ###        ######################### ######################## ######
####### ########## ######################### ######################## ######
####### ########## ######################### ######################## ######
#######            ######################### ######################## ######
####### #################################### ######################## ######
####### #################################### ######################## ######
####### #################################### ######################## ######
####### #################################### ######################## ######
####### #################################### ######################## ######
####### ############################################################# ######
#                                                                         S#
############################################################################
