#######################################################################################################################################################
S   #     #     #             #         #   #       #     #     # #   #       #       #     #           #         #             #     #       #       #
# # # ### ##### # ######### # # ### ### ### # ####### ### ##### # # # # ##### # ##### ##### ########### # ######### ##### ##### ### ### ####### ##### #
# #   # #   #   #   #       #   #   #   #   #     #     # #     #   #     #   # #     #     #       # #       #   #   #   #   #   #   #             # #
# ##### ### # ##### # ### ####### ####### ### ### # ##### # ############# ##### ### # # ##### # ### # ### ### # # ##### ##### ### # # ### ########### #
#     #   #   #   # #   # #       #     # #   #   # # #   # #           #   #     # # # #     # #   # # # #   # # #   # #   #     # #       #   #     #
##### ### ##### # # ##### # ####### ### # ##### # # # # # # # ######### ### # ### ### # ####### ##### # # ##### # # # # # # # ##### ######### # # ### #
# #   # #   #   #     #   #       # #     #     #   #   # # # #   #   # #   #   # #   # #   #     #     #   #   #   #   # #   #   # #     #   #   #   #
# # # # ### # ##### ### ####### # ### # ### ############# # # # # # # # # ####### # ### # # # ### # ####### # ########### ####### # # ##### ####### ###
# # #     # # #   # #   #   #   #   # # #       #       #   # # #   # # #       # #     # #   #   #   #   # # # #         #       # #       #     #   #
# # ####### # ### ### ### # # ##### # # ####### ##### ####### # ##### # ### ### # ####### ########### # # # # # # ########### ### # # ##### # ### ### #
#     #     #   # #   # # #   #   #   # #     #     #     # # # #     # #   #   #       #   #   #       #   # #   # #   #   # #   # #   # #     # #   #
##### # ####### # # ### # ##### ####### # # # ##### ##### # # # # ##### # ### ######### ### ### # ### ####### ##### # # # # ### ### ### # ##### # # ###
#   # # #     # #   #   # #   #     # #   # #     #   #   #   # #       #   #         #   # #   # #   #   #         # #   # #   # # #   #       # #   #
# # # # # ### # ##### ### ### ##### # ##### ####### # # ####### ########### ######### ### # # ##### ##### # ### ##### ##### # ### # ############# #####
# #   # #   # # #   #     #         # #   #         #   #         #     #   #     #     # # #     #       #   #     # #   #   #   # #   #         #   #
# ##### ### # # # ######### # ####### # # ############### ####### # ##### ### ### ##### # # ##### ### ####### ##### # # # ##### # # # # # ######### # #
#     # #   # # # #       # # #       # #     #       # #   # #     # #   #   # #       # # #     #   # #   # #     # # #   #   # # # #     #   # # # #
##### # ### # # # # ##### # # # # ##### # ### # ##### # ### # # # ### # ### ### ######### # # ##### # # # # # # ### # # ### # ### # ######### # # # ###
#   #       #           #   #   #   #   # #   #   #   # #   # # #   # # #   #       #     # # #   # # # # #   #   #   # # #     # #   #     # # # #   #
# ##### ####### ### ############# # # ### ####### # ### ### # # ### # # ##### ##### # ##### # # # # # # # ##### # ##### # ### # ##### ### # ### # ### #
#       #   #   # #     #   #     # # #     #     # #       # #   #   #       #   # # #   # # # # # #     #   # #   #   #   # # #   # #   #     #   # #
######### # ##### ##### # # ####### # # ### # # ### ######### ### ### ####### # # # # # # # # # # ########### ##### ### ### # # # # # # ######### # # #
# #     # #       # #   # #     #   # # #   # # # #       #   #   #   #     #   # #   # # # # # #         #   #   #   #     # #   #   # #   #     # # #
# # ### # ##### ### # ### ### ### ##### # ##### # ####### # ### ##### # ### ### # ##### # # # ########### # ### # # # ### ### ######### # # # ##### # #
#   # # #     # #     #   #       #     # #   # #   #     #   # #   # #   #   # #   #   #   #     #     #       # # # #   #   #     #   # #   #   # # #
# ### # ##### # ### ####### # ##### ##### ### # ### ### ##### # # # # ##### # # # ### ### ### ### ##### ######### ### # ### ### ### # ### ####### # # #
#   # # #   # #   #     #   # #   #   #   #     # #   # #     # # # # # #   # # # #     # #   #   #   #             # #   # # #   #   # #       #     #
### # # # ### ### ##### ##### # # ### # ### ##### ### # # ### # # # # # # ### # # # # ### ### # ### # ########### # # # # # # ### # ### ### # # ### ###
#     #   #   # # #   #   #   # #     # #   #   #     #   #   # # # # #     #   # # #   # #   #   # #   #       # #   # # # # # # #     #   # #   #   #
# # ####### ### # ### ### # ### ####### # # # # # ### ##### ### ### # # ### ##### ##### # # ##### # ### ####### # ##### # # # # # ### ### ####### ### #
# # #     # #   #         # #   #   #   # #   #   # # #   #     #   # #   # #   #     # #   #     #   #   #     # #     # # #   # #   #   #     #   # #
### # ### # # ############# # ### # # # # ####### # # ### ### ### ### ### # ### # ### # ##### ####### ### # ##### ######### # ### ### # ### ### ### # #
#   #   # # #         #   #   #   # # #   #       #   #   #   #     #   # #   #   # # # #     #   # #   # #     # #       # #   # #   # #   # #     # #
# ####### # ### ##### # # ### # ### # ##### ### ##### # ### ####### ### # ### ##### # # # ##### # # ##### ##### # # ##### # # ### # ### # ### ####### #
# #   #   #   #   #   # # #   # # # # #     # #   # #   #   #   #   #   # #   #     # # #   #   # #             # #   #     # #   #     # #   #   #   #
# # # # # # # ##### ##### ##### # # # ####### ### # ##### ##### # ### ### # ##### ### # ### # ### # ############# ### # # ### # ######### ### # # # # #
#   #   #   #                   #   #   #   #     #       #   #   #   #   # #   # #     #   # #   #       #     # # # # # # # #   #     #     # # # # #
####### ########### ############# ### # ### ############### # # ### ##### # # # # ### ### ##### ### ##### # ### # # # ### # # ### ##### ####### # # # #
#       #           #             #   #       #     #       #   #   #   # #   # #     #   #   #   #   #   # #   # # # #         # #   # #     # #   # #
# ####### ########### ############# ####### # # ### # ########### ##### # ##### ####### ##### # ##### # ### # ### # # # ##### # # # # # # ##### ##### #
# #   #   # #         #   #       # # #   # # # #   #       #   # # #   # # #   #     #       #   # # #   # # # # #   #   #   # #   #   # #     #     #
# ### # ### # ######### # # ##### # # # ### # # # ####### # ### # # # # # # # # # # # ######### # # # ### # # # # ####### # ### # ####### # # #########
#   # #   # #   #   #   # # #   # #   #   # #   #         #   # # #   #   #   #   # #         # # #     # # #     #       # #   #     # #   #   #   # #
### # ### # # # # # # ### ### # # ####### # ####### ######### # # # ####### ################# ### ### # # # ################# ####### # ######### # # #
# # # #   #   # # # # #   #   # #   #     # #     #         #   # #     # # #               # #   #   # #         #   #     #   #   #   #   #   # #   #
# # # ######### ### # ### # ### ### # ##### # ### ######### ### ####### # # # ############# # # ### ### # # ##### # # # # # ### # # # ### # # # # ### #
#   #   #     #     # #   #   #   # # #   # # #   #   #   #   #   # #   #   #     # #   #   #   #   #   # # #   # # #   # #     # # #     #   # # #   #
### ### # ### # ##### # ##### ### # # ### # # # ### # # # ### ### # # ##### ##### # # # # ########### ##### # ### # ######### ##### ########### ### ###
#   # # # # # #     # #     #   #   # #   #   # #   # # # #     # #     #   #   #   # # # #       # # #     #   #   #     #   #   #     #     #   #   #
# ### # # # # # ### # ### ##### ##### # ####### ### ### # ### ### ### # ##### ##### ### # # ##### # # # # ### # ######### # ##### ##### # ### ### # # #
#     # # # #   # # # # #   #   #   #       #   #     # #   # #   #   # #   #     #   # #   #     #   # #   # #   #       # #   #       # #   #   # # #
### ### # # # ### # # # ### # ##### ### ##### # # # # # ### ### ### ##### # ##### ### # ####### ########### ##### # ####### # # # ####### ##### ##### #
#   #   #   #   # # # #       #   #   #       # # # # # # # #   #   # #   # #   # #   #   #     #   #     # #       #   #     #     #   #   #     #   #
# ### ######### # # # ##### ##### # ### # # ##### # # # # # # ### ### # ### ### # # ##### # ##### # ### # # # ##### # # ########### # ##### ##### # ###
#     #       # # #       # #     #     # # #     # #   #   #     #   #   #             # # #     # #   # # # #     # #           #         #     # # #
####### ##### # # ######### # ########### ### ########### # ####### # ##### ##### ##### # # # ##### # ### # # # ############# ### ########### # ### # #
# #   #     #   #     #     #       #   # #   #           #   #   # # #     #     # #   #   # #   # #   #   # #         #   # # #   #   # #   #     # #
# # ### ############# # ########### # # # # ### ######### ### ### # # # ##### ##### # ####### ### # # ####### # ### ### ### # # ### ### # # # ### ### #
#       #               #         #   #   # #   #     #   #   #   # #   #   # #   # # #     #     # # #   #   # # # # #   # #   #   #     # #   #   # #
######### ########### ### ####### ##### ### # ### ### ##### # # ### ####### # # # # # # ### ####### # # # # # # # # # ### # ### # ### ##### # # # ### #
# #     #   #   #   #   # #     #     # #   # # #   # #     #     # #       #   # #   # # # #         # # # # # #   #     #     #   #     # # # #     #
# # ### # ### # # # ### # ##### ####### # ### # ### # # ######### # # ### ####### ##### # # # ##### ### # # ### ##### # ### # # ### ### # # # ####### #
# # # # #     # # #   # #     #       # # #   #     # # #         #   # # #   #   #   # #     #   # #   # # #   #   # # #   # #   #   # #   #     #   #
# # # # ####### ##### # ##### ### ### # # # ### ### ### ############# # # # # # ### # # ####### # # # ### ### # # # # # ##### ####### # ########### ###
# #   # #     #     # #   #     #   # # # #   # #   #   #   #   #     #   # # #   # #   # #     #   # # #     # # # # # #   #       #   #         # # #
# ##### # ### ### # # ### # ### ### # # # # # # # ### ### # # ### ######### # # ### ##### # ######### # ####### ### # ### # ####### ##### ##### # # # #
#   #   # #   #   # #     #   #   # #     # #   #   # #   # # #   #     #   # #   # #     #   #     # #       #     #   # #     #   #     #   # #   # #
### # ### ##### ### ######### ### # ### ### ####### # # ### # # ####### # ### ### # ### # ### # ### # ####### ######### # ##### # ### ####### ####### #
# # #   #       #   #     # # #   #   # # # #   #   #     #     #   #   #   #   # #   # # #     # #   #     # #   #       #     #   #   #     #     # #
# # ### ######### ####### # # ####### # # # # ### ##### # ######### # ##### ##### ### # # ### ### ######### # ### # ### ### ####### ### # ##### ### # #
# #     #       # #         #         # #     #       # #   #   #   #     # #         # # #   #   #     #   #   # # # # # # #       #     #   #   # # #
# ##### # ### ### # ##### ############# ####### ####### # # ### # # ### # # # ### ##### # # ### ### ### # # ### # # # # # # # ####### ##### # ### # # #
# #   #   # #     #   #   #           # # #   #     #   # #   # # # #   # #   #   #     #   #   #   # #   # # #     # # # #   #     #   #   # #   # # #
# # # ##### ######### ##### # ##### ### # # # ##### # ### ### # # ### ### ##### ### ########### ##### ##### # ### ### # # ####### ##### ##### # ### # #
# # #     #       # #       #   #   #   #   # #     #   # #   # #   # #   #     # #     #     #   #   #   # #     #     # #     #     # #     #   # # #
# # ##### ##### # # ##### ##### ##### ####### # ####### ### ### ### # ##### ##### ### # ##### ### # ### # # ####### # ### ##### ##### # # ####### # # #
# # #   #   #   # # #   # #   #     #       # #       # #   #   # # #     #   # #     #   #   #   #   # # # #   # # #     #   # #   #   #         #   #
# # # # # ### ### # ### # # ####### ####### # ######### # ### ### # ### ##### # ######### # ### ### # # # # # # # # ####### # # # # ############# # ###
# #   # #   #   # #       # #               # #         #   #     #   #     # # #   # #   # # #   # # # #   # # # #   #   # #   # #         # #   #   #
# ##### ### ##### ##### ### # ##### ######### # ######### # # # ##### ##### # # # # # # ### # # # # # # ##### # # ### # ### ############### # # #######
# #     #   #           # # #   #       #   # #     #   # #   #         # # #   # # # #   # #   # # # #     # #       #   #   #       #       #   #   #
# # # ##### # ########### # ### ##### # # # # ##### ### ############### # # ### # # # ### # ##### # ####### # ######### # ### ### ### # ### # ### # # #
# # # #   #   #   #       # # #     # #   # #   #   #         #     #   # # #   # # #       #   # #     #   #           # #   #   #   # #   #   # # # #
# # ### # ####### # ####### # ##### ####### ### # ### ####### # ##### ### # ### # # ### # ### # # ##### # # ############# # ### ### ##### ##### # # # #
# #   # # #   #   #   #           # #   #     #   #   #     # #   #   #   # #   # #   # #     # #         # #             # #   #       # # #   #   # #
# ### # # # # # ### # ####### # # # # ### ######### ### ### # ### # ### # # # ####### ######### ####### ##### ############# # ######### # # # ### ### #
#   #   # # #   # # #     #   # #   #   # #   #     # #   #   # # # #   #   #       #         #       # #   # #   #         # #         # #   #     # #
### ##### # ##### # ##### # ########### # # # # ### # ### # ### # # # ### ######### ######### # ##### # ### # ### # # ####### ########### ##### ### # #
# #     #   #     #     # # #       #   #   #   #   #     # #   # #   #   #         #   #   # #   #   #     # #   # # #   # #   #     #   #     #   # #
# ### # ####### ####### # # ####### ### ##### ############### ### ##### ############# ### # # ##### ####### # # ### # # # # ### # ### # ### ##### #####
#   # # #     # #   #   #     #   # #         #   #           #   #     #           #     # #       #       #   #   # # # #     #   # #   # #   #     #
### # # # ### # # # # ##### # # ### # ### ##### # # ########### ### ########### ### ####### ######### ########### ### ### # ####### # ### # # ####### #
#   # # #   # # # # #     # # #   # #   # #   # #     #       #     #       #   #   # #       #     # #     #   #   # #   #   # #   #     # #       # #
# # # # ##### # # # ##### # # ### # ##### # ### ##### # ######### ####### ### ### ### # ### # # # ### # ### # ##### # # ##### # # ######### ### # ### #
# #   #         # #       # #   # # #   # # #   #   # # #         #   #   #     # #   #   # # # #     # #   #     # #   #     # #       #     # # #   #
# ########### ### ######### ### # # # # # # # ### # ### # ######### # # ### ##### # # ### # # # # ##### # ####### # ####### ### ####### # ##### # # # #
#           # # # #   #     # # # # # #   # # #   #     # #   #     # #   # #   #   #     # # # #     # # #   # #     #           #   # #       # # # #
############# # # # # ####### # # # # ##### # # ######### # # # # # # # ### ### ########### # # ##### # ### # # ##### # ######### # ### ######### # # #
#         #   #   # #   #   # #     #   #   # # #       #   #   # # # #       # #           #   #     #   # # # #   # # #   #     #         #     # # #
# ####### # ####### ### # # # # # ##### # ### # ####### ########### # ##### # # # ############### ####### # # # # # # # ### # ############# # ##### ###
#       # # #       #   # # # # # #   # #   #         #   #         #       # # # #     #       #       #   #   # # # # #   # #         # # # #   #   #
####### # # ####### ##### # # # # # ### # # ### ##### ### # ################# # # # ### # ##### ####### ####### ### # # # ##### ####### # # # # # ### #
#   #   # #       #     # #   # # #   #   #   #   #   #   #           #   #   # # # #   #     #     #   #       #   #     #     #     # # # # # #     #
# # # ########### ##### # ##### ##### ####### ##### ### ############# # # # ### ### ######### ##### # ####### ### ### # ### ##### ##### # # # # #######
# #               #   # #     #     #       # # #     # #           #   # #   #   #   # #     #   # #       # # # #   # #   #   # #     # # # #   #   #
# ######### ####### # # ##### ### ####### # # # # # ### # ############### ### ### ### # # ##### # # ##### ### # # # ### # ### # # ### ### # ##### # # #
#   #   # #       # #       #     #     # # #   # # #             #       # #     #   # #       # #       #   # # #   # #     #   #   #     #   # # # #
### # # # ####### ##### # ######### ### ### ### # ### ############# ####### # ##### ### ######### ######### ### # ##### ####### ### ### ##### # # # # #
# # # # #       #   #   # #   #       # #       #   # # #   #     #   #     # #     # #     #     #     #   # #       # #     #   #     #     #     # #
# # # # ####### ### # ### # # # ##### # # # ##### # # # # # # ### ### # ##### # ##### ##### # # ### ### # ### ### ### # # ### ### ### ####### ### ### #
# #   # #     #   #   # # # #   # #   #   # #   # #       #     #     # #     #   #       #   # #   #       #     # #     #     #   # #     # #   #   #
# ##### # ### ### ##### # ### ### # ####### # # ########### # # ####### # ####### ####### # ### # ### ##### # ##### ### ### ### # # ### ### # #########
#     #     # #   #     #     # #   #     # # #             # # # #   # #   #   #     # # # #   #   # #   #   #   #   # #   #   # #   #   #   #       #
##### # ### # # ####### ####### # ### ##### # ########### ### # # # # # ### # # ##### # # ### ####### ### ##### ##### # # ### ####### ### ### # ### # #
#     #   # # # #   # # #     #   # #   #   # #   #       #   #   # #     #   #     # # #   #   #   # #     #     # #   # #   #     # # # # # # # # # #
# ### ##### # # ### # # # # # ##### ### # ### # # ######### ### ### ##### ##### # ### # ### ### # # # # ### # ### # ##### ### # ### # # # # # # # # ###
# #   #     # # #   #     # #     #   #   #   # #   #     # # #     # #   #     # #   #   # #   # #   # #   #   #       # #   # #   # #   # # # # #   #
# ##### ####### # ######### ##### # # ##### ####### # ### # # ####### # ### ####### ##### # # ### ### ### ############# # # ### # ### # ### # # # ### #
# #   # #   #   #     #     #   # # # #       #   # #   #   #   # #     #   #     #     #   # #   #       #     #     #   #     #   # #     #   #     #
# # # # # # # ##### ### ##### # # # # ##### # # # # # ####### # # # # ### ####### ##### # # # ### # # ######### # ### ############# # # ###############
# # #     # #   #     # #   # #   # #   #   # # # #   #   #   # # # #   #               # # # #   # #   #       # # # #     #   # # # #     #     #   #
# ##### ### ### ##### # # # # ##### ### ##### # # ##### # # ### # # ### ######### ######### # # ### ### # # # # # # # # ### # # # # # ##### ##### # # #
#       #       #   #   # # # #   #   # #     # # #     # # #   #   #   #   #     #   #     #   #     # # # # # # # #   #   # #     #     # #     # # #
######### # # ### # ##### ### # ##### # # ####### # ####### ##### ### ### ### ### ### # ############# # ### # ### # ##### ### ######### ### # ##### # #
#   #   # # # #   #           # #     #   #     # #       #       #   #   #     #     # # #         # # #   # #   #     #   # #         #     #     # #
# ### # # # ### ######### ##### # ######### ### # ####### ##### # # ### ### # ##### ### # # ####### # ### # # # ##### ##### # # ######### # ### ##### #
# #   # # # #   #   # #   #   #     #   #   # # #       #   #   # #   # #   #   # #     # # #       #     # #   #   #       #   #     # # # #   #     #
# # ### # # # ### # # # ### # ####### # # ### # # ######### ######### # # ##### # ##### # # # ############# ##### # # ####### ### ### # # # # ### ### #
# # # # # # # #   #   #     #         #   #   # # #       #         # #   #   # # #   # # # #       # #   # #   # # # #       #   # #     # # #   # # #
# # # # ### # # ################# ##### ### ### # # ##### ######### # ##### # # # # # # # # ####### # # # ### # # # # # ######### # ### ### # # ### # #
#   # #     # #   # #           # #   #     #   # # #     #       # # #   # # #   # #     # #       #   #     # # # # # #   #     # #   # #   #   # # #
# ### ####### ### # # ####### # # # # ####### ### # ####### ##### # # # # # # ##### ### ### ##### # ########### # # # # # # # ##### # ### ##### # # # #
#   #       #   #   # #     # #   # #       #   # # #       #   #     # # # #   #   #   # #   #   # #             #   #   # # #   # # #   #   # # #   #
### ##### # ### # # # # ### ####### ####### ### # # # ####### ##### ##### # ### ### # ### ### ####### ######### ########### # ### # # # ### # ### #####
# #     # # #   # # # #   # #     # #     #   #   # #   #   #           # #   #   # #     # #   #   # #   #     #     #     # #   # #   # # # #   #   #
# ### # # # # # # ### ##### # ##### # ####### ##### ### # # ######### # # # ##### ######### ### # # # # # # ##### ### # ##### # ### ##### # ### ### # #
#     #   # # # #     # #     #     # #         # #       # #   #   # # # #   # # #   #   #     # #   # #   #   # #   #     # # #     #   # #   #   # #
######### # # # ####### # ##### # ### # ####### # ##### ### # # # # # # # # # # # # # # ### ##### ##### ##### # # # ####### # # # ##### # # # ####### #
#         #   #     #   #     # # #   # # #       # #   #   # # # # # #   # #   # # #       #         #     # # # #       # # # #       # #   #     # #
# ################# # ####### ### # ### # # # ##### # ### ##### ### # ##### ### # ##### ######### ### ##### # # # ####### # # # ######### # # # ### # #
#       #     #   # # #   # #     # #   # # #         # #     # #   #   #   # # #   #   #         #   #   #   #   #   #   #   # #           # # #   # #
####### # ### ### # # # # # ####### # ### # ########### ### # # # ##### ##### # # # # ### ######### ### ########### # # ####### # ####### ##### # ### #
#     #   #   #   #   # # #         #   # #   #     # # # # #     #             # # #   # #   #   #   #       #     # # #   # # #       # #   # #   # #
# ### ##### ### # ### # # ##### # ### ### ##### ### # # # # ### ####### ######### # ### # ### # ##### ### ### ### # # # ### # # # ##### # # # # ### # #
#   #       #   #   # # #     # #   #   # # #   #   # #     # # #       #   #   # # #   #   # #     # #   #   #   # # #   # # #   #   # # # # # # # # #
### # ####### ####### # ##### # ### ### # # # ### ### ### ### # # ####### # # # ### # ##### # ##### # # ##### # ### ##### # # ##### # # # # # # # # # #
# # #   #   #         # #     # #   #   #   # #   #       # #   # #   #   # # #     # #     #   #   # # #     # #           #     # # # # # #   #   # #
# # ### ### ### ######### ##### # ####### # # ####### ### # ##### # # # ### # ####### # ####### # ### ### ##### # ####### ### ### # ### # # ######### #
#     #       #           #     #         #           #   #         #   #   #         #         #         #     #       #     #   #     #             F
#######################################################################################################################################################
